                                                                
                         42222222222225                         
 4222222222222222222222227            8222222222222222222222225 
 3                                                            3 
 3                                                            3 
 3                                                            3 
 3                                                            3 
 3                                                            3 
 3                                                            3 
 3                                                            3 
 3                                                            3 
 3                                                            3 
 3                                                            3 
 3                                                            3 
 3                                                            3 
 3                                                            3 
 3                                                            3 
 3                                                            3 
 3                                                            3 
 3                                                            3 
 3                                                            3 
 3                                                            3 
 3                                                            3 
 3                                                            3 
 3                                                            3 
 3                                                            3 
 3                            9110                            3 
 31111111111111111111111111111c  d11111111111111111111111111113 
 3                            a11b                            3 
 3                                                            3 
 3                                                            3 
 3                                                            3 
 3                                                            3 
 3                                                            3 
 3                                                            3 
 3                                                            3 
 3                                                            3 
 3                                                            3 
 3                                                            3 
 3                                                            3 
 3                                                            3 
 3                                                            3 
 3                                                            3 
 3                                                            3 
 3                                                            3 
 3                                                            3 
 3                                                            3 
 3                                                            3 
 3                                                            3 
 3                                                            3 
 3                                                            3 
 3                                                            3 
 8222222222222222222222225            4222222222222222222222227 
                         82222222222227                         
                                                                
